NO ./textures/north.xpm
SO ./textures/south.xpm
EA ./textures/brickwall.xpm
WE ./textures/brickwall.xpm
DO ./textures/door.xpm

F 245,245,220
C 135,206,235

111111111
102000201
111000111
102000201
111121111
101000101
121000121
1000N0001
111111111