NO ./textures/brickwall.xpm
SO ./textures/brickwall.xpm
EA ./textures/brickwall.xpm
WE ./textures/brickwall.xpm

F 245,245,220
C 135,206,235

11111111
10000001
10111101
10000001
10000001
100E0101
10000001
11111111