NO ./textures/north.xpm
SO ./textures/south.xpm
EA ./textures/brickwall.xpm
WE ./textures/brickwall.xpm
DO ./textures/door.xpm

F 245,245,220
C 135,206,235

11111111
10000001
10121101
10000001
10000001
100N0201
10000001
11111111