NO ./textures/north.xpm
SO ./textures/south.xpm
WE ./textures/west.xpm
EA ./textures/east.xpm
DO ./textures/door.xpm

F 245,245,220
C 135,206,235

  11111111111111111111111
1110000000000000000000001
1000000000000000000000001
1111111111111100000000011
             100000000011
1111111111111100011111111
1000000000000000000001
1111111112111111111111
    100000000000000001
111110011N111101110001111111
 1100000000000000110001
1100000111010101111111111111
11110111 1110101 111111
11111111 1111111 111111