NO ./textures/north.xpm
SO ./textures/south.xpm
WE ./textures/west.xpm
EA ./textures/east.xpm
DO ./textures/door.xpm

F 245,245,220
C 135,206,235

        111111111111111111111111111111111111111111111111
        10000000001100000000S0000000000000000000000020111
        10110000011100000000000111111111111111111111111
        10010000000000000000000111111111 1111111 111111111111
1111111110110000011100000000000111111111 1111111 111111111111
1000000000110000011101111111111111111111 1111111 111111111111
1111011111111101110000001000111111111 1111111 111111111111
1111011111111101110101001000111111111 1111111 111111111111
1100000011010101110000001000111111111 1111111 111111111111
1000000000000000110000001000111111111 1111111 111111111111
1000000000000000110101001000111111111 1111111 111111111111
110000111101010111110111100011111111111 1111111 111111111111
11110111 1110101 10111101000111111111 1111111 111111111111
11111111 1111111 11111111111111111111 1111111 111111111111
11111111 1111111 11111111111111111111 1111111 111111111111
11111111 1111111 11111111111111111111 1111111 111111111111