NO ./textures/north.xpm
SO ./textures/south.xpm
WE ./textures/west.xpm
EA ./textures/east.xpm
DO ./textures/door.xpm

F 245,245,220
C 135,206,235

       111111111111111111
1111111100110000000000001
1000000000110000000000S01
1011000001110000000000001
1000000000110000000000001
1001000000000000000000001
1011111110110000011100001
1011111110110000011100001
1011111110110000011100001
1111111110110000011100001
   1000000011000001110001
   1111111111111111111111