NO ./textures/north.xpm
SO ./textures/south.xpm
EA ./textures/brickwall.xpm
WE ./textures/brickwall.xpm
DO ./textures/door.xpm

F 245,245,220
C 135,206,235

1111
1N01111111
1111