NO ./textures/north.xpm
SO ./textures/south.xpm
EA ./textures/east.xpm
WE ./textures/west.xpm
DO ./textures/door.xpm

F 245,245,220
C 135,206,235

11111
10201
10N01
10001
11111